111111111111111111
110110011000CEP011
10P100110011000011
100C0C00C1010C0111
111111111111111111